[
    {
        "type" : "tutorial",
        "id" : "tutorial",
        "name" : "tutorial",
        "see_cost" : 5,
        "mapgen": "special" [
            { "weight": 1000,
            "method": "json", "object": {
                "fill_ter": "t_grass",
                "rows":[
xxxxxxxxxxxxxxxxxxxxxxxxxxxxxxxxxxxxxxxxxxxxxxxxxxxxxxxxxxxxxxxx------------------------------------
x6.....x.....................................................x-
x...@..x                                                      |                                    -
x......x         +                                                    |                                    -
xxxx+xxx                                                    | OUTDOORS, sparesely forested       -
x@tributes|              LOBBY                                 + Surrounded with metal bars.        -
x         +                                                    |                                    -
x_+______6|                                                    |                                    -
xtips     +                                                    | ~~~~~~                             -
x________6|                                                    | ~~~~~~                             -
xeaster   |____+______________+____________________+__________6| ~~~~~~                             -
xegg      |{           |Books & Skills  |Construction          | ~~~~~~                             -
x         |items       |  {{{{{{{{{{{   |                      | ~~~~~~                             -
x         |&           +                |                      | ~~~~~~                             -
x         |inventory   |  {{{{{{{{{{{   |                      | ~~~~~~                             -
x________6|____+______6|                |                      |                                    -
x         |            |_______+_______6|                      +                                    -
xweaponry |clothing,   |Crafting        |                      |                                    -
xand      |armor,      |&               |                      |  foraging bushes                   -
xexplosive|and         |Tools           |                      |                                    -
x         +            +                +                      |                                    -
x         |encumberance|                |                     6|                                    -
x         |            |                |                      |                                    -
x___+____6|___________6|_______+_______6                       |                                    -
xfiring   |Agony & you |                |                      |                                    -
x range   |            | Happy Drugs    |                      +                                    -
x         |            |                |                      |                                    -
x         |            |Staying Healthy |                      6                                    -
|D   D   D|"Medical    +_______________6|6                     | ^                                  -
|         |treatment"  |                                       |^                                   -
|         |            | Vehicle construction/Cart             | ^                                  -
|    >    +            |                                       6                                    -
|________6|___________6|_______________________________________|||||||||||||||||++|||||||||||||||||||


Character spawns with all skills at 1 with 12 int, quick, some bubblewrap, and a pair of jeans. Default rest, and no other items. 
Easter egg room should have special walls.
The big lobby area is a placeholder for NPC behaviors and bases when or if it is fully implemented.
Lobby should also contains markers, scribbled grafitti, a damaged shopping cart and some newspaper articles/pamphlets showing what the survivor knows.
D is for Dummy.
6s are terminals/levers.
Computer terminals display all messages associated with the room.
Construction room has a garage exit.
Crafting and tools door should be locked.
{ are shelves and bookcase
^ are beartraps.
Spawns of items can be randomized with exceptions listed:
"Needs to be at least one ammo box for a gun in the weapons room, and a knife.
Clothing needs to be 1/4th fitted items and always include a backpack.
Tools room must include a jackhammer, a pot, and a hotplate.
Construction room needs to have welder, hacksaw, welding mask, gas pump, shovel, and wrench.
Vehicle construction needs to have a mostly finished golf cart, with spare ties.
Library contains books for improving vehicle crafting and fabrication, and no advanced textbooks.
Medical treatment contains soldering iron and bandages."
